CBD_BONUS

--Wall textures--
W1 ./data/textures/tree_wall1.png
W2 ./data/textures/shack_wall.png
W3 ./data/textures/dome_entrance.png
W4 ./data/textures/dome_wall.png
W5 ./data/textures/shack_wall_window.png
W6 ./data/textures/shack_wall_window_outside.png
W7 ./data/textures/wall_sky_stars.png
W8 ./data/textures/shack_wall_tag.png

--Breakable wall textures--
W= ./data/textures/shack_wall_cracked1.png
W- ./data/textures/shack_wall_cracked2.png
W_ ./data/textures/shack_wall_cracked3.png

--Enemy--
e po ./data/textures/sprites/po_animation_sprite_dismemberment2.png 128 128 1 100 1 02,02

--Pickupables--
i chainsaw ./data/textures/sprites/chainsaw.png 128 128 28,28

--Debugging
i fuel ./data/textures/sprites/fuel.png 128 128 12,02

--Checkpoint
--o checkpoint ./data/textures/sprites/dark_secret_shrub.png 32 32 13,02

--Jumpscare--
o trigger1 ./data/textures/sprites/tree_bear.png 128 128 29,16
e trigger2 ./data/textures/sprites/po_animation_sprite_dismemberment2.png 128 128 3 100 1 23,20

--Shrubs--
o decor ./data/textures/sprites/dark_secret_shrub.png 32 32 03,29
o decor ./data/textures/sprites/dark_secret_shrub.png 32 32 10,31
o decor ./data/textures/sprites/dark_secret_shrub.png 32 32 30,21

o decor ./data/textures/sprites/baby_on_hook.png 128 128 29,28

--Trees--
o decor ./data/textures/sprites/tree.png 128 128 08,28
o decor ./data/textures/sprites/tree.png 128 128 02,30
o decor ./data/textures/sprites/tree.png 128 128 02,31
o decor ./data/textures/sprites/tree.png 128 128 08,31
o decor ./data/textures/sprites/tree.png 128 128 15,32
o decor ./data/textures/sprites/tree.png 128 128 23,27
o decor ./data/textures/sprites/tree.png 128 128 23,32
o decor ./data/textures/sprites/tree.png 128 128 20,27
o decor ./data/textures/sprites/tree.png 128 128 16,30
o decor ./data/textures/sprites/tree.png 128 128 25,25
o decor ./data/textures/sprites/tree.png 128 128 21,10
o decor ./data/textures/sprites/tree.png 128 128 23,19
o decor ./data/textures/sprites/tree.png 128 128 22,20

--Blood--
o decor ./data/textures/sprites/blood3.png 64 64 16,15
o decor ./data/textures/sprites/blood1.png 64 64 15,11
o decor ./data/textures/sprites/blood2.png 64 64 15,09
o decor ./data/textures/sprites/blood3.png 64 64 15,07
o decor ./data/textures/sprites/blood1.png 64 64 17,06
o decor ./data/textures/sprites/blood2.png 64 64 15,03
o decor ./data/textures/sprites/blood3.png 64 64 12,02
o decor ./data/textures/sprites/blood3.png 64 64 28,28

o tv ./data/textures/sprites/dark_secret_tv3.png 128 128 29,30

--Floor & ceiling colors
F 85,55,55
C 85,55,55

--Fuel--
i fuel ./data/textures/sprites/fuel.png 128 128 28,29
i fuel ./data/textures/sprites/fuel.png 128 128 29,24
i fuel ./data/textures/sprites/fuel.png 128 128 08,02
i fuel ./data/textures/sprites/fuel.png 128 128 09,07
i fuel ./data/textures/sprites/fuel.png 128 128 04,11
i fuel ./data/textures/sprites/fuel.png 128 128 02,21

--Map--
11111111111111111111111111111111
10444444444444440000000000000001
14000000000000040000000000000001
10444444044444004000000000000001
14040004040000400400000000000001
14040004040000040040000000000001
14044444044000100040000000000001
14000000004001000010000000000001
14044404444001000100000011110001
14040004000001000100111100001001
14044444400001000107000000000101
14000000400001000100110011000011
14044440400000100010100100100001
14000000434000010001100010010001
14044440404000001000110001001001
14000000404000000100011000100101
14044444404000000010001100011001
14040400004000000010000000100101
14044404444000000001100001010101
14000004000000000000010010000101
14044404000000000000100100001001
14040404000000000000077700010001
14440404000000000000000000100001
10000404000000000000000001000001
10000404000000000000000010000011
10000444000000000000000100000111
10000111000000000111111000262221
10001000100000001000000002258221
10010000010000010000000002000021
1010000000100010001100E00-000051
17000011000111000100100002000021
17000101010000000100010002252221
11111111711101101111111011111111
11111111111171171111111711111111
11111111111111111111111111111111
