NO ./data/textures/north_tex.png
SO ./data/textures/south_tex.png
WE ./data/textures/west_tex.png
EA ./data/textures/east_tex.png
F 220,100,0
C 225,30,0
1111111111111111
1111111111111111
1111111101111111
1111111101111111
1111111101111111
1111111101111111
1111111101111111
1111111101111111
1111000000000011
11110000N0000011
1111000000000011
1111111111111111
1111111111111111
1111111111111111
1111111111111111
1111111111111111
