CBD_BONUS

W1 ./data/textures/tree_wall1.png
W2 ./data/textures/shack_wall.png
W3 ./data/textures/tree_wall1.png
W4 ./data/textures/dome_entrance.png
W5 ./data/textures/dome_wall.png

W= ./data/textures/shack_wall_cracked1.png
W- ./data/textures/shack_wall_cracked2.png
W_ ./data/textures/shack_wall_cracked3.png

o decor ./data/textures/sprites/dark_secret_shrub.png 03,29
o decor ./data/textures/sprites/dark_secret_shrub.png 15,17
o decor ./data/textures/sprites/dark_secret_shrub.png 06,30
o decor ./data/textures/sprites/dark_secret_shrub.png 10,31
o decor ./data/textures/sprites/dark_secret_shrub.png 22,31
o decor ./data/textures/sprites/dark_secret_shrub.png 03,22
o decor ./data/textures/sprites/dark_secret_shrub.png 19,26
o decor ./data/textures/sprites/dark_secret_shrub.png 06,18
o decor ./data/textures/sprites/dark_secret_shrub.png 04,14
o decor ./data/textures/sprites/dark_secret_shrub.png 17,12
o decor ./data/textures/sprites/dark_secret_shrub.png 03,19
o decor ./data/textures/sprites/dark_secret_shrub.png 18,09
o decor ./data/textures/sprites/dark_secret_shrub.png 06,11
o decor ./data/textures/sprites/dark_secret_shrub.png 04,01
o decor ./data/textures/sprites/dark_secret_shrub.png 28,05
o decor ./data/textures/sprites/dark_secret_shrub.png 03,12
o decor ./data/textures/sprites/dark_secret_shrub.png 13,06
o decor ./data/textures/sprites/dark_secret_shrub.png 07,08
o decor ./data/textures/sprites/dark_secret_shrub.png 04,04
o decor ./data/textures/sprites/dark_secret_shrub.png 21,16
o decor ./data/textures/sprites/dark_secret_shrub.png 17,14
o decor ./data/textures/sprites/dark_secret_shrub.png 19,03

o decor ./data/textures/sprites/dark_secret_tv.png 15,16

F 25,0,0
C 0,0,0

11111111111111111111111111111111
11111111111111151141115111111111
10000000300300005505550000000001
10300000000000000000000000300001
10000003000000030000030000000001
10000000000300000000000030000001
10030000000000000000000000000001
10000000300000300030000300030001
10000000000000000000000000000001
10000300000030000003000003003001
10000030300000000000000030000001
10000300000000000000000300000001
10000000000030000000000000000001
10300000000000000000000000000001
10000000000000000000003000000001
10030000000000000000000300000301
10000000000000000000000000000001
10000000000000000000030000000001
10003000030000003000000000030001
10000000000000000000000300000001
10003000000030030030000000000001
13000000000000000000030000030001
10000000300000030000000000000001
10000030000000000000300000030001
10030000000030000300000030000001
10000000000000000000000000003001
10000003000000000003000000000001
10000000000003000000003002222221
10000000000000000000000002000021
1300003000000000300003000=000021
10000000000300000000000002222221
1E000000300000000000300000000001
11111111111111111111111111111111
