CBD_BONUS

W1 ./data/textures/tree_wall1.png
W2 ./data/textures/shack_wall.png
W3 ./data/textures/dome_entrance.png
W4 ./data/textures/dome_wall.png
W5 ./data/textures/shack_wall_window.png
W6 ./data/textures/shack_wall_window_outside.png
W7 ./data/textures/wall_sky_stars.png

W= ./data/textures/shack_wall_cracked1.png
W- ./data/textures/shack_wall_cracked2.png
W_ ./data/textures/shack_wall_cracked3.png

e po ./data/textures/sprites/po_animation_sprite_dismemberment.png 128 128 1 9 1 28,30

i chainsaw ./data/textures/sprites/chainsaw.png 128 128 28,28

o decor ./data/textures/sprites/dark_secret_shrub.png 32 32 03,29
o decor ./data/textures/sprites/dark_secret_shrub.png 32 32 10,31
o decor ./data/textures/sprites/dark_secret_shrub.png 32 32 30,21

o decor ./data/textures/sprites/tree.png 128 128 08,28
o decor ./data/textures/sprites/tree.png 128 128 02,30
o decor ./data/textures/sprites/tree.png 128 128 02,31
o decor ./data/textures/sprites/tree.png 128 128 08,31
o decor ./data/textures/sprites/tree.png 128 128 15,32
o decor ./data/textures/sprites/tree.png 128 128 23,27
o decor ./data/textures/sprites/tree.png 128 128 23,32
o decor ./data/textures/sprites/tree.png 128 128 20,27
o decor ./data/textures/sprites/tree.png 128 128 16,30
o decor ./data/textures/sprites/tree.png 128 128 25,25

o decor ./data/textures/sprites/blood3.png 64 64 16,15
o decor ./data/textures/sprites/blood1.png 64 64 15,11
o decor ./data/textures/sprites/blood2.png 64 64 15,09
o decor ./data/textures/sprites/blood3.png 64 64 15,07
o decor ./data/textures/sprites/blood1.png 64 64 17,06
o decor ./data/textures/sprites/blood2.png 64 64 15,03
o decor ./data/textures/sprites/blood3.png 64 64 12,02


o decor ./data/textures/sprites/dark_secret_tv2.png 128 128 29,30

F 25,0,0
C 0,0,0


11111111111111111111111111111111
10444444444444440000000000000001
10300000000000040000000000000001
10444444444444004000000000000001
10000000000000400400000000000001
10000000000000040040000000000001
10000000000000100040000000000001
10000000000001000010000000000001
10000000000001000100000011110001
10000000000001000100000100001001
10000000000001000100001000000101
10000000000001000100010011000011
10000000000000100010100100100001
10000000000000010001100010010001
10000000000000001000110001001001
10000000000000000100011000100101
10000000000000000010001100011001
10000000000000000001000000100101
10000000000000000000100001000101
10000000000000000000010010000101
10000000000000000000001100001001
10000000000000000000000000010001
10000000000000000000000000100001
10000000000000000000000001000001
10000000000000000000000010000011
10000000000000000000000100000111
10000111000000000111111000262221
10001000100000001000000002252221
10010000010000010000000002000021
1010000000100010001100E000_00051
17000011000111000100100002000021
17000101010000000100010002252221
11111111711101101111111011111111
11111111111171171111111711111111
11111111111111111111111111111111
