
NO ./data/textures/north_tex.png
SO ./data/textures/south_tex.png
WE ./data/textures/west_tex.png
EA ./data/textures/east_tex.png
F 220,100,0
C 225,30,0
1111111111111111
1111111111111111
1111000000000011
1101000000000011
1111011111111111
1100000000000011
1111000000000011
1111000000000011
1111000000000011
1111000000000011
1111000000000011
1110000000000011
1110001111111111
1110W01111111111
1111111111111111
1111111111111111
