NO ./data/textures/north_tex.png
SO ./data/textures/south_tex.png
WE ./data/textures/west_tex.png
EA ./data/textures/east_tex.png
F 9,45,56
C 0,0,0
1111111111111111
1111101111111111
1111000000000011
1111011101111111
1110011101111111
1111011101111111
1111000001111111
1110011111101111
1111000000000011
1111111101111111
1110000000000011
1110111111111111
1110111111111111
1110111011111111
1110000000000W11
1111111111111111
