CBD_BONUS

W1 ./data/textures/rabbit_hole_wall.png

W= ./data/textures/rabbit_hole_wall_cracked.png
W- ./data/textures/rabbit_hole_wall_cracked.png
W_ ./data/textures/rabbit_hole_wall_cracked.png

F 0,30,0
C 0,0,0

11111111111111111111111111111111
101010100011111111100000_0000001
10101010101111111110000011111111
10101010101111111110000000000001
1010101_101111111110000011111111
101010101010000000_00000_0000001
10101010101111111110000011111111
11_010101011111111100000_0000001
10101010101111111110000011111111
1010_000100000000000000000000001
1_111111111111111111111111111101
10111111000000_00000000000000001
101000000111111111111111111111_1
10101111010000000000000000000001
10101001011111111111111111111111
10_0100100000000000000000_000001
10101001111111111111111111111101
1010100000N_00000000000000000101
111_111111111111111_111111111101
10_011101011100_0000000001000001
10101110101110101111101101010001
10101110101110101100000100010001
10101110101110101111111111111111
10101110_01110100000000010000001
10101110111111111_11111010000001
1010111010_0100010100010_0000001
10101110101010111010101010000001
10100000101010001000101010000001
1011111110101000_011101_11111111
10000000001000001000101000000001
1_11111111111111111_101111111111
10000000000_00000000100000000001
11111111111111111111111111111111
