NO ./data/textures/north_tex.png
SO ./data/textures/south_tex.png
WE ./data/textures/west_tex.png
EA ./data/textures/east_tex.png
F 220,100,0
C 225,30,0
1111111111111111
1010101010101011
1010101010101011
1010101010101011
1010101010101011
1010101010101011
1010101010101011
1010101010101011
1010101010101011
1010101010101011
1010101010101011
1010101010101011
1010101010101011
1010101010101011
1101010101010N11
1111111111111111
