NO ./data/textures/north_tex.png
SO ./data/textures/south_tex.png
WE ./data/textures/west_tex.png
EA ./data/textures/east_tex.png
F 255,0,0
C 255,0,0
1111111211111111
1000000000000001
2000000N00000002
1000000000000001
1111111211111111
