CBD_BONUS

W1 ./data/textures/the_bunker_wall.png
W2 ./data/textures/the_bunker_window.png
W3 ./data/textures/the_bunker_control_wall.png
W4 ./data/textures/the_bunker_propaganda_wall.png

W= ./data/textures/the_bunker_wall_cracked1.png
W- ./data/textures/the_bunker_wall_cracked2.png
W_ ./data/textures/the_bunker_wall_cracked3.png

F 40,40,0
C 0,0,0

11111111111111111111111111111111111
11112111111111112111111111112111111
11110111111111110111111111110111111
1100000=000000000000000=00000000111
1111=11111411133331111141111111=111
11100001000001300310000000010000111
11100001000001300310000000010000111
12000001000001300310000000000000111
11100001000000000310000000010000111
11100001000001300310000000010000111
11100001000001300310000000010000111
11100004000004300340000000040000021
11100001000001300310000000010000111
11100001000001300310000000010000111
12000001000001300310000000010000111
11100001000001300310000000010000111
11100001000001300310000000010000111
11110111111101300311111110111101111
11100001000001300310000000010000111
11100004000004300310000000010000021
12000001000001300310000000010000111
11100001000001300310000000010000111
11100001011111300311101111110111111
11100001000001300310001000000000111
11100000000001300310001000000000111
11100001000004300310004000000000021
12000001000001300000001000000000111
11100001000001300310001000000000111
11100001000001333310001000000000111
1111141111110111111101111141111=111
11100000100000000100000000000010111
11100000000000000100000000000010111
12000000100000000400000000000010111
111N0000100000000100000000000010111
11111411111101111111111011111111111
11111111111121111111111211111111111
11111111111111111111111111111111111
