NO ./data/textures/north_tex.png
SO ./data/textures/south_tex.png
WE ./data/textures/west_tex.png
EA ./data/textures/east_tex.png
F 255,0,0
C 255,0,0
1111111111111111
1000000000000001
1011000000000001
1000000000000001
1111011111111111
1000000000000001
1111000000000011
1111000000000011
1111000000000011
1111000000000011
1111000000000011
1110000000000011
1110001111111111
1110001111111111
1100N00000000011
1111111111111111
